.........................................
.........................................
..................................#######
..........######..................#......
......................######.....#.......
...@..####........#.........#...#........
####.........................##..........
.....................#...................
...................##....................
.........................................
.........................................
#########################################