.........................................
.........................................
.........................................
...........###.#.........................
........................####.............
.........#........###.......###..........
....####..........###....................
..................###............#.......
@.................###............#.......
#############################....########
#############################....########
#############################....########
#############################....########